###########################################
#......##...........##...........##.......#
#.....$##......$....##...........##.......#
#......##...........##...........##.......#
#...................##...........##.......#
#......##...........##...........##.......#
#......##...........##...........##.......#
#......##...........##...........##.......#
#......##...........##....................#
#......##...........##...........##.......#
#......##...........##...........##..$....#
#......##...........##...........##.......#
#......##...........##...........##.......#
#......##...........##...........##.......#
#......##...........##...........##.......#
#......##...........##...........##.......#
#...>..##...........##$..........##.......#
#......##...........##...........##.......#
#......##...........##...........##.......#
#......##...........##...........##...$...#
#......##...........##...........##.......#
#......##...........##...........##.......#
#......##...........##........$..##.......#
#......##...........##...........##.......#
#......##...........##...........##.......#
#......##...........##...........##.......#
#......##...........##...........##.......#
#......##...........##...........##.......#
#..$...##...........##...........##.......#
#......##...........##...........##.......#
#......##..........$##...........##.......#
#......##...........##...........##.......#
################.#######.##################
################.#######.##################
#........##.........##.....$##............#
#........##.........##......##............#
#........##.........##......##............#
#........##.........##......##............#
#...................##......##............#
#........##........$##......##............#
#.....$..##.........##......##............#
#........##.........##......##............#
#.....$..##.........##......##............#
#....$...##.........##......##............#
#E...@...##.........##......##.......$....#
#........##.........##...$..##............#
#........##.........##......##...$........#
#........##.......$.##......##............#
#........##.........##......##...$........#
#........##.........##....................#
#........##.........##......##............#
#........##.................##............#
#........##.........##......##............#
#.......$##.........##..$...##............#
###########################################
