################################################
#.................##...........................#
#.................##...........................#
#.................##...........................#
#.................##...........................#
#.................##...........................#
#.................##...........................#
#.................##...........$...............#
#.................##...........................#
#.................##...........................#
#.................##...........................#
#.................##.......................$...#
#.................###########################.##
#.................###########################.##
#.................##...........................#
#.................##.......................$...#
#.................##...........................#
#.................##...........................#
#.##################...........................#
#.##################...........................#
#.................##...........................#
#..$..............##...........................#
#.................##...........................#
#.................##...........................#
#..........$......##...........................#
#.................##...........................#
#........@.....................................#
#.................##...........................#
#.................##...........................#
#.................##...........................#
#.................##...........................#
#..........$......##...........................#
######################################.#########
######################################.#########
#.................##...........................#
#E...............$##...........................#
#.................##...........................#
#............$....##...........................#
#.................##......$....................#
#.................##...............$...$.......#
#.................##...........................#
#.................##...........................#
#.................##...........................#
#.................###########################.##
#.................###########################.##
##.#################...........................#
##.#################...........................#
#..............$..##...........................#
#.................##...........................#
#.................##...........................#
#................$##.............>.............#
#..............................................#
#.................##...........................#
#...$.............##...........................#
#.................##...........................#
################################################
