########################################
#............$.##......................#
#..............##......................#
#..............##......................#
#..............##......................#
#..............##......................#
#..............##......................#
#..............##$.....................#
#..............##......................#
#.......@.....$##......................#
#..............##......................#
#..............##......................#
#..............##......................#
#........$.....##......................#
#..............##......................#
#..............##......................#
#..............##......................#
#..............##......................#
###.##############################.#####
###.##############################.#####
#..............##......................#
#..............##......................#
#..............##......................#
#.$............##......................#
#..............##......................#
#..............##......................#
#..............##......................#
#..............##......................#
#..............##......................#
#......$.......##......................#
#..............##......................#
#..............##......................#
#..............##......................#
#.......$......##...........>..........#
#..............##......................#
#..............##......................#
#..............##......................#
#..............##......................#
#..............##......................#
#..............##......................#
#..............##......................#
#..............##......................#
#..............##......................#
#......................................#
#..............##......................#
#..............##......................#
#..............##......................#
########################################
