###########################################
#...............##.......................$#
#.........$.....##........................#
#...............##........................#
#...............##..$.$...................#
#...............########.##################
#...............########.##################
#...............##........................#
#........$......##........................#
###.##############...........$............#
###.##############........................#
#...............##........................#
#...............##........................#
#.........................................#
#....E.$........##........................#
#...............##...$.................E..#
#.#########################################
#.#########################################
#...................##....................#
#...................##....................#
#...................##................$...#
#...................##....................#
#...................##....................#
#...........................$.............#
#...................##....................#
#...................##....................#
#...................##....................#
#...................##....................#
#...................##....................#
###.####################################.##
###.####################################.##
#...............$...##....................#
#.......$..........$##....................#
#...................##....................#
#...................##....................#
#...................##....................#
#...................##.......$............#
#.........>.........##..........@.........#
#...................##....................#
#...................##....................#
#...................##....................#
#...................##....................#
#...................##............$.......#
###########################################
